0000000000000000000000000000000000000000000000
0000000000000000000000000000000000000000000000
0000000000000000000000000000000000000000000000
0000000000000000000000000000000000000000000000
0000000000000000000000000000000000000000000000
0000000000000000000000000000000000000000000000
0000000000000000000000000000000000000000000000
0000000000012222100000000000000000000000000000
0000000000012222100000000000000000000000000000
0000000011011111100000000000000000000110000000
1111100000000000001222222221111133333333001410
0000000000000000001222222221000133111111001110
0000000000000000001222222211000133100000000000
0000000000000000001222222221000133100000000000
0000000000000000001111111111000111100000000000