0000000000000000000000000000000000000000000000000000
0000000000000000000000000000000007000000000000000000
0000000000000000000800000000000000000000000000000000
0000000000000000000000000000000000000000000000000000
0000000001000000000000000001000000010000000000000000
0000001000000000000000000000000000000001000000000040
1111111111111155111111155111111111111111111111111111