000000000000000000000000000000000000000000000000000000000000
000000000000000000000000000000000000000000000000000000000000
000000000000000000000000000000000000000000000000000000000000
000000000000000000000000000000000000000000000000000000000000
000000000000000000000000000000000000000000000000000000000000
000000000000000000000000000000000000000000000000000000000000
000000000000000000000000011111000000000000000000000000000000
000000000000000000000000000100000000000000000000000000000000
000000000000000000000000000100000000000000000000000000000000
000000000000000000000000000100000000000000000000000000000000
000000000000000000000000000100000000000000000000000000000000
000000000000000000000000000100000000000000000000000000000000
000000000000000000000000000100000000000000000000000000000000
000000000000000000000000000100000000000000000000000000000000
000000000111111110000000000100000000000000777777777000000000
000000000000100000000000000100000000000000000000000000000000
000000000000100000000000000100000000000000000000000000000000
000000000000100000000000000100000000000000000000000000000000
000000000000100000000000000100008888888880000000000000000000
000000000000100000000000000100000000000000000000000000000000
000000000000100000000000000100000000000000000000000000000000
000000000000100000000000000100000000000000000000777777770000
000000000000122222222222222100000000000000000000000000000000
000000000000000000000000000100000000000000000000000000000000
000000000000000000000000000100000000000000000000000000000000
000000000111111100000000000100000888888880008800000000000000
000000000000100000000000000100000000000000000000000000000000
000000000000100000000000000100000000000000000000000000000000
000000000000100000000000000100000000000000000000000000000000
000000000000100000000000000100000000000000000000777777700000
000000000000100000000000000100000000000000000000000000000000
000000000000100000000000000100000000000000000000000000000000
000000333333100000000000000100000000000000000000000000000000
000000000000100000000000000100111111111000000000000000000000
000000000000100000000000000100000000000000000000000000000000
000000000000100000000000000100000000000000000000000000000000
000044444440100000000000000100000000000000000004444444400000
000044444440100000000000000100000000000000000004444444400000