11111111011111111111111111111111111111111111111111111111111111111111111111111111111111111111111111
11111111100111111111111111111111111111111111111111111111111111111111111111111111111111111111111111
11110000000011111111111111111111111111111111111111111111111111111111111111111111111111111111111111
11111111100111111111111111111111111111111111111111111111111111111111111111111111111111111111111111
11111111011111111111111111111111111111111111111111111111111111111111111111111111111111111111111111
00000000000000000000001111110000000000000011111111111111111111111111111111111111111111111111111111
00000000000000000000000000000000000000000000000111111111111111111111111111111111111111111111111111
11111166111111100011000000000000000000000000000000000000000011111111111111111111111111111111111111
11111100111111111111111223311222133312222111000000000000000111111111111111111111111111111111111111
11111100111111111111111111111111111111111111111111111111100111111111111111111111111111111111111111
11111100111111111111111111111111111111111111111111111111100000000000000000000000000000000000000001
11111100111111111111111111111111111111111111111111111111100000000000000000000000000000000000000001
11111100111111111111111111111111111111111111111111111111100111111111111111111111111111111111111111
11111100111111111111111111111111111111111111111111111111100111111111111111111111111111111111111111
11100000000000000000000000000000000000000000000000000000000111111111111111111111111111111111111111
11100000000000000000000000000000000000000000000000000000000000000000000000000000000000000001111111
11100666666001111111111111111111111111111111111111111111100000000000000000000000000000000001111111
11100666666000111111111111111111111111111111111111111111133111111111111111111111111111112222111111
11100666666660011111111111111111111111111111111111111111133111111111111111111111111111111111111111
11100666666666001111111111111111111111111111111111111111133111111111111111111111111111111111111111
11100666666666600111111111111111111111111111111111111111111111111111111111111111111111111111111111
11100666666666660000111111111111111111111111111111111111111111111111111111111111111111111111111111
11040666666666660040011111111111111111111111111111111111111111111111111111111111111111111111111111