1111111111111111111111111111111111111111111111111111111111111111111111111111111
1000000000000000000000000000000000000000000000000000000000000000000000000000001
1000000000000000000000000000000000000000000000000000000000000000000000000000001
1000000000000000000000000000000000000000000000000000000000000000000000000000001
1000000000000000000000000000000000000000000000000000000000000000000000000000001
1000000000000000000000000000000000000000000000000000000000000000000000000000001
1000000000000000000000000000000000000000000000000000000000000000000000000000001
1000000000000000000000000008000000000000000000000000000000000000000000000000001
1000000000000000000000000000000000000000000000000000000000000000000000000000001
1000000000000000000000000000000000000000000000000000000000000000000000000000001
1000000000000000000008000000000000000000000000000000000000000000000000000000001
1665551110000000000000000000000000000000000000000000000000000000000000000000001
1000000020000000000000000070000000000000000000000000000000000000000000000000001
1000000020000000000000000000000000000000000000000000000000000000000000000000001
1000000020000000000000000000000000000000000000000000000000000000000000000000001
1000000020000000000000000000000000000000000000000000000000000000000000000000001
1000000020000000000000000000000000000000000000000000000000000000000000000000001
1000000020000000000000000000000000000000000000000000000000000000000000000000001
1000000000000000000000000000000000000000000000000000000000000000000000000000001
1000000000000000000000000070000000000000000000000000000000000000000000000000001
1000000000000000000000000000000000000000000000000000000000000000000000000000001
1000000000000000000000000000000000000000000000000000000000000000000000000000001
1000880000000001100000000000000000000000000000000000000000000000000000000000001
1000000000000000000000000000000000000000000000000000000000000000000000000000001
1000000000000000000000000000000000000000000000000000000000000000000000000000001
1000000000000000000000000000000000000000000000000000000000000000000000000000001
1000000000000000000000000080000000000000000000000000000000000000000000000000001
1077000000000008800000000000000000000000000000000000000000000000000000000000001
1000000000000000000000000000000000000000000000000000000000000000000000000000001
1000000000000000000000000000000000000000000000000000000000000000000000000000001
1000000000000000000000000000000000000000000000000000000000000000000000000000001
1000000000000000000000000000000000000000000000000000000000000000000000000000001
1000000000000000000000000000000000000000000000000000000000000000000000000000001
1000000000110000000000110000000000000000000110000000000000000000000000000000001
1000000000000000000000000000000000000000000000000000000000000000000000000000001
1555555555555555555555555555554455555555555555555555555555555555555555555555551