00000000000000000000000000000000000000000000000000000000000000
00000000000000000000000000000000000000000000000000000000000000
00000000000000000000000000000000000000000000000000000000000000
00000000000000000000000000000000000000000000000000000000000000
00000000000000000000000000000000000000000000000000000000000000
00000000000000000000000000000000000000000000000000000000000000
00000000000000000000000000000000000000000000000000000000000000
00000000000000000000000000000000000000000000000000000000000000
00000000000000000000000000000000000000000000000000000000000000
00000660000001100000000000000000000000000000000000000000000000
00000000000000000000000110000000000000000000000000000000000000
00000000000000000000000000001100000110000000000000000000000000
00000000000000000000000000000000000000000000000000000000000000
00000000000000000000000000000000000000000011000000000000000000
00000000000000000000000000000000110000000000000000000000000000
00000000000000000000006600000000000000000000000000000000000000
00000000000000000000000000000000000000000000000010000000000000
00000000000000000000000000000000000000011000000000000000000000
00000000000000000000000000000660000000000000000000000010000000
00014410000000000000000000000000000000000000000000000000000000
00011111555555555555555555555555555555555555555551111111111111